aback=ADV. назад 
abandon=отказываться от (Р)  оставлять покидать 
abandoned=покинутый  распутный 
abandonment=оставление 
abase=унижать 
abasement=унижение 
abash=смущать 
abashment=смущение 
abate=VT уменьшать  VI утихать (о буре и т.п.) 
abatement=уменьшение  скидка 
abattoir=скотобойня 
abbess=настоятельница монастыря 
abbey=монастырь 
abbot=аббат настоятель м. 
abbrevlate=сокращать 
abbrevlation=сокращение 
abdicate=отрекаться от престола  отказываться от (Р) 
abdication=отречение от престола 
abdomen=живот  брюшная полость 
abduct=похищать (женщину) 
aberration=заблуждение  аберрация 
abet=VT подстрекать содействовать (дурному) 
abettor=подстрекатель(-ница) 
abeyance=состояние неизвестности 
abhor=ненавидеть 
abhorrence=отвращение 
abhorrent= отвратительный 
abide=VI пребывать  VT not ~ не терпеть 
abide by=твердо держаться (Р) 
ability=способность 
abject= презренный жалкий 
abjure=отрекаться от (Р) 
able= способный 
able-bodied=здоровый  годный 
abnegate=отказывать себе в (П)  отрицать 
abnegation=отрицание  (само-)отречение 
abnormal= ненормальный 
aboard=N на корабль на корабле 
abode=1) PT. от abide  2) местопребывание  жилище 
abolish=отменять  упразднять 
abolition=отмена 
abominable= отвратительный 
abominate=VT питать отвращение к (Д) 
abomination=отвращение 
aboriginal=1) туземный  2) туземец 
abortion=выкидыш аборт 
abound=изобиловать (in Т) 
about=1) PRP. вокруг (Р)  около (Р)  (П) об (П) обо (П) насчет (Р)  у (Р)  про (В)  I had no money ~ me # у меня не было с собой денег  2) ADV. вокруг везде  приблизительно 
above=1) PRP. над (Т)  выше (Р)  свыше (Р)  2) ADV. наверху наверх  выше  3) ADJ. вышесказанный 
above all=главным образом 
abreast=в ряд 
abrige=сокращать 
abrigement=сокращение 
abrigment=сокращение 
abroad=за границей за границу  there is a report ~ ходит слух 
abrogate=VT отменять  аннулировать (IM)PF. 
abrupt= обрывистый  внезапный  резкий 
abscond=VI скры(ва)ться 
absence=отсутствие  отлучка 
absence of mind=рассеяность 
absent=1)  отсутсвующий  2) ~ O.S. отлучаться 
absent-minded= рассеянный 
absolute= абсолютный  беспримерный 
absolution=отпущение грехов 
absolve=прощать  освобождать (from от Р) 
absorb=впитывать  абсорбировать (IM)PF. 
absorption=всасывание впитывание  FIG. погруженность (в думы) 
abstain=воздерживаться (from от Р) 
abstemious= воздержанный умеренный 
abstention=воздержание 
abstinence=умеренность  трезвость 
abstinent= умеренный воздержанный непьющий 
abstract=1) # отвлеченный абстрактный  2) конспект  извлечение  GR. отвлеченное имя существительное  3) отвлекать  резюмировать (IM)PF. 
abstracted=отвлеченный 
abstraction=абстракция 
abstruse= FIG. непонятный темный 
abundance=избыток изобилие 
abundant= обильный богатый 
abuse=1) злоупотребление  оскорбление  брань  2) злоупотреблять (Т)  ругать 
abusive= оскорбительный 
abut=граничить (upon с Т) 
abyss=бездна 
academic=академический 
academical= академический 
academician=академик 
accede to=вступать в (В) 
accelerate=ускорять 
accelerator=ускоритель 
accent=1) ударение  произношение акцент  2) VT делать или ставить ударение на(П) 
accentuate=делать или ставить ударение на (П)  FIG подчеркивать 
accept=принимать  соглашаться с (Т) 
acceptable= приемлимый  приятный 
acceptance=прием принятие  $ акцепт 
access=доступ  проход  приступ 
accessary=соучастник(-ица) 
accessible= доступный достижимый 
accession=вступление (to в В)  доступ (to к Д) 
accession to the throne=вступление на престол 
accessory=1)  добавочный второстепенный  2) PL принадлежности 
accident=случайность  катастрофа авария 
accidental= случайный 
acclaim=шумно приветствовать (В)  аплодировать (Д) 
acclamation=шумное одобрение 
acclimatize=акклиматизировать(ся) (IM)PF. 
acclivity=подъем (дороги) 
accomodate=приспособлять  давать жилье (Д) 
accomodation=приют  помещение 
accompaniment=аккомпанемент  сопровождение 
accompany=VI аккомпанировать (Д)  сопровождать 
accomplice=соучастник(-ица) 
accomplish=выполнять  достигать (Р) 
accomplishment=выполнение  достижение 
accomplishs=PL образованность 
accord=1) соглашение  гармония  2) VI согласовываться (с Т)  гармонировать (с Т)  VT представлять 
accordance=согласие 
accordant= согласный (с Т) 
according to=согласно (Д) 
accordingly=ADV. соответственно  таким образом 
accost=заговаривать с (Т) 
account=1) счет  отчет  take into ~ tаkе ~ of # принимать во внимание  2) VI ~ for # отвечать за (В)  объяснять 
accountable= объяснимый 
accountant=счетовод  (chartered Am. certified public ~ # присяжный) бухгалтер 
accounting=отчетность  учет 
accredit=аккредитовать (IM)PF.  приписывать 
accrue=накопляться  происходить (from из Р) 
accumulate=накапливать(ся)  скоплять(ся) 
accumulation=накопление  скопление 
accuracy=точность  тщательность 
accurate= точный  тщательный 
accursed=проклятый 
accurst=проклятый 
accusation=обвинение 
accuse=VT обвинять 
accuser=обвинитель(ница) 
accustom=приучать (to к Д) 
accustomed=привычный  приученный 
ace=туз  FIG первоклассный летчик 
acerbity=терпкость 
acetic=уксусный 
acetify=окислять(ся) 
ache=1) боль  2) VI болеть (о части тела) 
achieve=достигать (Р) 
achievement=достижение 
acid=кислый  едкий 
acidity=кислота  едкость 
acknowledge=VT подтверждать  призна(ва)ть 
acknowledgement=признание  расписка 
acknowledgment=признание  расписка 
acme=высшая точка (Р)  кризис 
acorn=# желудь 
acoustics=акустика 
acquaint=VT знакомить 
acquaintance=знакомство  знакомый 
acquire=VT приобретать  достигать (Р) 
acquirement=приобретение 
acquisition=приобретение 
acquit=VT оправдывать  выполнять (обязанности)  ~ O.S. well # хорошо справляться с работой 
acquit of=освобождать от (Р) 
acquittal=оправдание 
acquittance=уплата (долга и т.п.) 
acqulesce=молча или неохотно соглашаться (in на В) 
acqulescement=молчаливое или неохотное согласие 
acre=акр (0.4 га) 
acrid=острый едкий 
across=1) ADV. поперек  на ту сторону  крестом  2) PRP. сквозь (В) через (В) 
act=1) VI действовать  поступать  VT THEA. играть  2) дело  постановление  акт 
act on the spur of the moment=действовать под влиянием минуты 
acting=1) исполняющий обязанности  2) действия  THEA. игра 
action=поступок  действие (а. THEA.)  деятельность   бой  иск 
active= активный  энергичный  деятельный 
activity=деятельность  активность  энергия 
actor=актер 
actress=актриса 
actual= действительный 
actuate=приводить в действие 
acute= острый  проницательный 
adamant=FIG несокрушимый 
adapt=приспособлять (to for к Д) 
adaptation=приспособление  переделка  аранжировка 
add=VT прибавлять   складывать  VI увеличи(ва)ть (to В) 
addict=наркоман 
addicted=склонный (to к Д) 
addition= сложение  прибавление 
additional= добавочный дополнительный 
address=1) адресовать (IM)PF.  обращаться к (Д)  2) адрес  обращение  речь 
addressee=адресат 
adept=адепт 
adequacy=соразмерность 
adequate= достаточный  адекватный 
adhere=прилипать (to к Д)  FIG. придерживаться (to Р) 
adherence=приверженность 
adherent=приверженец(-нка) 
adhesive= липкий клейкий 
adhesive plaster=липкий пластырь 
adhesive tape=липкий пластырь 
adjacent= смежный (to с Т) соседний 
adjoin=примыкать к (Д)  граничить с (Т) 
adjourn=VT откладывать  отсрочи(ва)ть  PARL. делать перерыв 
adjournment=отсрочка  перерыв 
adjudge=выносить приговор (Д) 
adjust=1) приводить в порядок  2) приспособлять  прилаживать  TE регулировать  выверять  устанавливать 
adjustment=регулирование  регулировка 
administ justice=отправлять правосудие 
administer=управлять (Т) 
administration=администрация 
administrative=административный  исполнительный 
administrator=администратор 
admirable= превосходный  восхитительный 
admiration=восхищение 
admire=восхищаться (Т) любоваться (Тна В) 
admissible= допустимый приемлемый 
admission=вход  допущение  признание 
admit=VT допускать 
admit to bail=# выпускать на поруки 
admittance=доступ вход 
admixture=примесь 
admonish=увещ(ев)ать (IM)PF.  предостерегать (of от Р) 
admonition=увещание  предостережение 
ado=суета  хлопоты 
adolescence=юность 
adolescent=юный юношеский 
adopt=VT усыновлять  усваивать 
adoption=усыновление  усваивание 
adoration=обожание 
adore=VT обожать 
adorn=украшать 
adornment=украшение 
adroit= ловкий  находчивый 
adult=взрослый совершеннолетний 
adulterate=фальсифицировать (IM)PF. 
adulterer=нарушающий супружескую верность 
adulteress=нарушающая супружескую верность 
adultery=нарушение супружеской верности 
advance=1) VI подвигаться вперед   наступать  продвигатся  делать успехи  VT продвигать  выдвигать 
advantage=преимущество  выгода 
advantageous= выгодный 
adventure=приключение 
adventurer=искатель приключений  авантюрист 
adventurous= предприимчивый  авантюрный 
adversary=противник(-ица)  соперник(-ица) 
adverse= враждебный 
adversity=бедствие несчастье 
advertise=рекламировать (IM)PF.  объявлять 
advertisement=объявление  реклама 
advertising=рекламный 
advice=совет 
advisable= желательный 
advise=VT советовать (Д)  VI советоваться (with с Тon about о П) 
adviser=советник(-ица) советчик(-ица) 
advocate=1) защитник (-ица)  сторонник(-ица)  адвокат  2) отстаивать 
aerial=1)  воздушный  2) антенна 
aero...=аэро... 
aerodrome=аэродром 
aeronaut=аэронавт 
aeronautics=аэронавтика 
aeroplane=самолет аэроплан 
aerostat=аэростат 
aesthetic=эстетичный 
aesthetics=эстетика 
afar=ADV. вдалеке вдали 
affair=дело 
affble=приветливый 
affect=действовать на (В)  заде(ва)ть  # поражать 
affectation=жеманство 
affected= жеманный 
affection=привязанность  заболевание 
affectionate=нежный 
affidavit=письменное показание под присягой 
affiliate=присоединять (как филиал) 
affinity=сродство 
affirm=утверждать 
affirmation=утверждение 
affirmative=утвердительный 
affix=прикреплять (to к Д) 
afflict=огорчать 
affliction=горе  болезнь 
affluence=изобилие богатство 
affluent=1)  обильный богатый  2) приток 
afford=позволять себе  I can ~ it # я могу себе это позволить  предоставлять 
affront=1) оскорлять  2) оскорбление 
afield=ADV. вдалеке  в поле  на войне 
afloat=N на воде  в море  в ходу 
afraid=испуганный 
afresh=ADV. снова сызнова 
African=1) африканец(-нка)  2) африканский 
after=1) ADV. потом после затем  позади  2) PRP. за (Т) позади (Р)  через (В)  после (Р)  3) CJ. с тех пор как  после того как  4) ADJ. последующий 
after-taste=(остающийся) привкус 
after-thought=мысль пришедшая поздно 
aftercrop=второй урожай 
aftermath=отава  FIG. последствия 
afternoon=время после полудня 
afterwards=ADV. потом 
again=ADV. снова опять  ~ and ~ time and ~ # тo и дело 
against=PRP. против (Р)  о об (В)  на (В) 
against the wall=у стены  к стене 
age=возраст  года'  эпоха 
aged=старый постаревший 
aged twenty=двадцати лет 
agency=действие  агенство 
agent=фактор  агент  доверенное лицо 
agglomerate=VT соб(и)рать  VI скопляться 
agglutinate=склеи(ва)ть 
aggrandize=увеличи(ва)ть  возвеличи(ва)ть 
aggravate=усугублять  ухудшать  раздражать 
aggregate=1) собирать(ся) в одно целое  2) # совокупный  3) совокупность  агрегат 
aggression=нападение  агрессия 
aggressor=агрессор 
aghast=ошеломленный пораженный ужасом 
agile= проворный живой 
agility=проворство живость 
agitate=VT волновать возбуждать  VI агитировать (for за В) 
agitation=волнение  агитация 
agnail=# заусеница 
agonize=быть в агонии  сильно мучить(ся) 
agony=агония  боль 
agree=VI соглашаться (to с Т на В) 
agree on=уславливаться о (П) 
agreeable=согласный (to с Т на В)  приятный 
agreement=согласие  соглашение договор 
agricultural=сельскохозяйственный 
agriculture=сельское хозяйство  земледелие  агрономия 
agriculturist=агроном  земледелец 
ague=лихорадочный озноб 
ahead=вперед впереди 
aid=1) помощь  помощник(-ица)  2) помогать (Д) 
ailing=больной нездоровый 
ailment=нездоровье 
aim=1) VI прицели(ва)ться (аt в В)  2) цель намерение 
aim at=FIG. иметь в виду  VT направлять (аt на В) 
aimless=бесцельный 
air=1) воздух  2) проветри(ва)ть  +  MST PL аффектация важничанье  give O.S. ~s # важничать  ++  # мелодия  песня  ария 
air precautions=PL противовоздушная оборона 
air-base=авиабаза 
air-brake=воздушный тормоз 
air-jacket=надувной спасательный нагрудник 
air-lift=(воздушный мост) воздушная перевозка 
air-liner=рейсовый самолет 
air-mail=воздушная почта 
air-port=аэропорт 
air-raid=воздушный налет 
air-route=воздушная трасса 
air-tight=герметический 
air-tube=камера шины  # трахея 
airconditioned=с кондиционированным воздухом 
aircraft=самолет 
airfield=аэродром 
airforce=военно-воздушный флот 
airman=летчик авиатор 
airplane=Am. самолет 
airshelter=бомбоубежище 
airship=дирижабль 
airway=воздушная трасса 
airy= воздушный  легкомысленный 
aisle=AR придел (храма)  проход 
ajar=приотворенный 
akin=родственный близкий (to Д) 
alarm=1) тревога  страх  2) тревожить волновать 
alarm-clock=будильник 
albuminous=содержащий белок  альбуминный 
alcohol=алкоголь  спирт 
alcoholic=1) алкогольный  2) алкоголик 
alcoholism=алкоголизм 
alcove=альков ниша 
ale=пиво эль 
alert=1)  живой проворный  2) (воздушная) тревога 
alien=1) иностранный  чуждый  2) иностранец чужестранец 
alienable=отчуждаемый 
alienate=отчуждать 
alienist=психиатр 
alight=1) сходить (с Р)  приземляться  2) ADJ. PREDIC. зажженный в огне  освещенный 
align=выравнивать(ся) 
alike=1) ADJ. PRED. одинаковый  похожий  2) ADV. точно так же  подобно 
aliment=питание 
alimentary=пищевой  питательный 
alimentary canal=пищевод 
alimony=алименты 
alive=живой бодрый  чуткий (to к Д)  кишащий (with Т) 
all=1) ADJ. весь вся все все PL  всякий  всевозможный  2) все все  for ~ (that) I care # мне безразлично  3) ADV. вполне всецело совершенно 
all along=вce время 
all at once=сразу 
all but=почти  едва не ... 
all found=на всем готовом 
all of a sudden=внезапно вдруг 
all over again=снова еще раз 
all over the town=по всему городу 
all the better=тем лучше 
all the year round=круглый год 
all-round=всесторонний 
allay=успокаивать 
allegation=заявление  голословное утвердение 
allege=ссылаться на (В)  утверждать (без основания) 
allegiance=верность преданность 
alleviate=облегчать 
alley=аллея  переулок 
alliance=союз 
allocate=размещать  распределять 
allocation=распределение 
allot=распределять  разда(ва)ть 
allow=позволять  допускать  Am. утверждать 
allowable= позволительный 
allowance=(материальное) содержание  скидка  разрешение 
alloy=1) примесь  сплав  2) сплавлять 
allright=хорошо ладно 
allude=ссылаться (to на В)  намекать (to на В) 
allure=завлекать 
allurement=обольщение 
allusion=намек  ссылка 
ally=1) соединять (to with с Т)  2) союзник 
almanac=календарь альманах 
almighty=всемогущий 
almond=1) миндаль  миндалина (а. #)  2) миндальный 
almost=почти едва не 
alms=SG. а. PL милостыня 
alms-house=богадельня 
aloft=наверху наверх 
alone=один одна одно  одни PL  одинокий(-кая)  let (или leave) ~ # оставить в покое 
along=1) ADV. вперед  2) PRP. вдоль (Р) по (Д) 
along with=вместе с (Т) 
alongside=бок-о-бок рядом 
aloof=поодаль в стороне 
aloud=громко вслух 
alp=горное пастбище 
Alps=Альпы 
already=уже 
also=также тоже 
alter=изменять(ся) 
alteration=перемена изменение переделка (to Р) 
alternate=1) чередовать(ся)  2)  переменный 
alternating current=E переменный ток 
alternation=чередование 
alternative=1) # взаимоисключающий альтернативный  переменно действующий  2) альтернатива  выбор возможность 
although=хотя 
altitude=высота  возвышенность 
altogether=вполне всецело  в общем 
aluminium=алюминий 
aluminum=алюминий 
always=всегда 
am=[IRR.] 1.PERS. SG. PERS. от bе 
amalgamate=амальгамировать (IM)PF. 
amass=соб(и)рать  накоплять 
amateur=любитель(ница)  дилетант(ка) 
amaze=изумлять поражать 
amazement=изумление 
amazing=удивительный изумительный 
ambassador=посол  посланец 
amber=янтарь 
ambiguity=двусмысленность 
ambiguous= двусмысленный  сомнительный 
ambition=честолюбие 
ambitious= честолюбивый 
amble=1) иноходь  2) идти иноходью 
ambulance=карета скорой помощи 
ambuscade=засада 
ambush=засада 
ameliorate=улучшать(ся) 
amend=исправлять(ся)  PARL. вносить поправки в (В) 
amendment=исправление  PARL. поправка (к резолюции законопроекту) 
amends=компенсация 
amenity=приятность 
amenityism=американизм 
amenityize=американизировать (IM)PF. 
American=1) американец(-нка)  2) американский 
amiable= дружелюбный  добродушный 
amicable= дружеский дружественный 
amid=среди (Р) посреди (Р) между (Т  sometimes Р) 
amidst=среди (Р) посреди (Р) между (Т  sometimes Р) 
amiss=ADV. плохо неправильно  некстати  несвоевременно 
amity=дружба 
ammonia=X аммиак 
ammunition=боеприпасы 
amnesty=1) амнистия  2) амнистировать (IM)PF. 
among=среди (Р) между (Т sometimes Р) 
amongst=среди (Р) между (Т sometimes Р) 
amorous= влюбленный (of в В)  влюбчивый 
amount=1) ~ to # равняться (Д)  2) сумма  количество 
ample= достаточный обильный  просторный 
amplification=расширение  увеличение  усиление 
amplifier=PHYS. усилитель 
amplify=усили(ва)ть  распространять(ся) 
amplitude=широта размах (мысли)  PHYS. # амплитуда 
amputate=ампутировать (IM)PF. отнимать 
amuse=забавлять позабавить PF. развлекать 
amusement=развлечение забава 
an=неопределенный член 
an understood thing=решенное дело 
anaesthetic=наркотик 
analogous= аналогичный сходный 
analogy=аналогия сходство 
analyse=анализировать (IM)PF. PF. а. 
analysis=анализ 
anarchy=анархия 
anatomize=анатомировать (IM)PF.  анализировать (IM)PF. 
anatomy=анатомия 
ancestor=предок 
ancestral=наследственный родовой 
ancestress=прародительница 
ancestry=происхождение  предки 
anchor=1) якорь  2) ставить (стать) на якорь 
anchovy=анчоус 
ancient=1) древний  античный  2) the ~s PL # HIST. древние народы