aback=ADV. назад 
abandon=отказываться от (Р)  оставлять покидать 
abandoned=покинутый  распутный 
abandonment=оставление 
abase=унижать 
abasement=унижение 
abash=смущать 
abashment=смущение 
abate=VT уменьшать  VI утихать (о буре и т.п.) 
abatement=уменьшение  скидка 
abattoir=скотобойня 
abbess=настоятельница монастыря 
abbey=монастырь 
abbot=аббат настоятель м. 
abbrevlate=сокращать 
abbrevlation=сокращение 
abdicate=отрекаться от престола  отказываться от (Р) 
abdication=отречение от престола 
abdomen=живот  брюшная полость 
abduct=похищать (женщину) 
aberration=заблуждение  аберрация 
abet=VT подстрекать содействовать (дурному) 
abettor=подстрекатель(-ница) 
abeyance=состояние неизвестности 
abhor=ненавидеть 
abhorrence=отвращение 
abhorrent= отвратительный 
abide=VI пребывать  VT not ~ не терпеть 
abide by=твердо держаться (Р) 
ability=способность 
abject= презренный жалкий 
abjure=отрекаться от (Р) 
able= способный 
able-bodied=здоровый  годный 
abnegate=отказывать себе в (П)  отрицать 
abnegation=отрицание  (само-)отречение 
abnormal= ненормальный 
aboard=N на корабль на корабле 
abode=1) PT. от abide  2) местопребывание  жилище 
abolish=отменять  упразднять 
abolition=отмена 
abominable= отвратительный 
abominate=VT питать отвращение к (Д) 
abomination=отвращение 
aboriginal=1) туземный  2) туземец 
abortion=выкидыш аборт 
abound=изобиловать (in Т) 
about=1) PRP. вокруг (Р)  около (Р)  (П) об (П) обо (П) насчет (Р)  у (Р)  про (В)  I had no money ~ me # у меня не было с собой денег  2) ADV. вокруг везде  приблизительно 
above=1) PRP. над (Т)  выше (Р)  свыше (Р)  2) ADV. наверху наверх  выше  3) ADJ. вышесказанный 
above all=главным образом 
abreast=в ряд 
abrige=сокращать 
abrigement=сокращение 
abrigment=сокращение 
abroad=за границей за границу  there is a report ~ ходит слух 
abrogate=VT отменять  аннулировать (IM)PF. 
abrupt= обрывистый  внезапный  резкий 
abscond=VI скры(ва)ться 
absence=отсутствие  отлучка 
absence of mind=рассеяность 
absent=1)  отсутсвующий  2) ~ O.S. отлучаться 
absent-minded= рассеянный 
absolute= абсолютный  беспримерный 
absolution=отпущение грехов 
absolve=прощать  освобождать (from от Р) 
absorb=впитывать  абсорбировать (IM)PF. 
absorption=всасывание впитывание  FIG. погруженность (в думы) 
abstain=воздерживаться (from от Р) 
abstemious= воздержанный умеренный 
abstention=воздержание 
abstinence=умеренность  трезвость 
abstinent= умеренный воздержанный непьющий 
abstract=1) # отвлеченный абстрактный  2) конспект  извлечение  GR. отвлеченное имя существительное  3) отвлекать  резюмировать (IM)PF. 
abstracted=отвлеченный 
abstraction=абстракция 
abstruse= FIG. непонятный темный 
abundance=избыток изобилие 
abundant= обильный богатый 
abuse=1) злоупотребление  оскорбление  брань  2) злоупотреблять (Т)  ругать 
abusive= оскорбительный 
abut=граничить (upon с Т) 
abyss=бездна 
academic=академический 
academical= академический 
academician=академик 
accede to=вступать в (В) 
accelerate=ускорять 
accelerator=ускоритель 
accent=1) ударение  произношение акцент  2) VT делать или ставить ударение на(П) 
accentuate=делать или ставить ударение на (П)  FIG подчеркивать 
accept=принимать  соглашаться с (Т) 
acceptable= приемлимый  приятный 
acceptance=прием принятие  $ акцепт 
access=доступ  проход  приступ 
accessary=соучастник(-ица) 
accessible= доступный достижимый 
accession=вступление (to в В)  доступ (to к Д) 
accession to the throne=вступление на престол 
accessory=1)  добавочный второстепенный  2) PL принадлежности 
accident=случайность  катастрофа авария 